C,C,C,C,C
C,C,C,C,C
C,C-b,C,C,C
C,C,C,R,C
C,R,C,C,R
C,R,C,C,M
C-a,C,C,C,C
